+ E + + + + + + + + 
+ N + + + + + + + + 
+ G W A L I O R + + 
+ L + + + + + + + + 
+ A + + + + + + + + 
+ N O R W A Y + + + 
+ D + + + G + + + + 
+ + + + + R + + + + 
+ + + + + A + + + + 
+ + + + + + + + + + 
1
